11111111111111111111
10000000000000000001
10000000000000000001
10000000000000000001
10000000000000000001
10001111000000000001
10000000000000000001
10000000001111000001
10000000000000000001
100000000s0000000001
10000000000000000001
10000000000000000001
10000000000000000001
10000000000000000001
10011111100000000001
10000000000000000001
10000000111111000001
10000000000000000001
10000000000000000001
111111111111111111111
